congratulations: congratulations|congrats|congratulate|congratulated|congratulating|felicitate|felicitation

superlative: brilliant|super|superb|beautiful|exquisite|astonishing|amazing|amazement|mindblowing|astounding|outstanding|astonish|astonished|fantastic|fabulous|electrifying|electrified|adulation|excellent|terrific|genius|priceless|rave|ravishing|gush|awesome|"awe inspiring"|awe-struck|awestruck|preeminent|"pre eminent"|standing ovation|gorgeous|marvel|marvellous|marvelous|stupendous|stunning|ooh|oooh|ooooh|"tour de force"

# gratitude: grateful|gratitude|generous|heartwarming|"heart warming" # no thanks!

pride: pride|proud|brag|bragging|bragged

joy: joy|joyous|happiness|euphoria|"high spirits"|lovely|wonderful|gleeful|glad|"thank god"|"thank goodness"|"good news"|rhapsodic|ecstasy|enraptured|ecstatic|jubilation|festivity|celebration|celebrate|"cloud nine"|"walking on air"|rapture|blissful|thrill|excited

surprise: surprise|surprised|surprising|unusual|incredible|astound|astonish|unbelievable

pos-surprise: remarkable|remarkably|omg # peculiar|strange

wow: wow

humor: joke|funny|slapstick|comedy|humor|humour|haha|hahaha|"ha ha"|lol|hilarious

milestones: milestones|centennial|anniversary|birthday|graduation|convocation|commencement|goodbye|ceremony|ceremonial

memories: memories|remember|memoir|memoirs|memorable|unforgettable|reminiscence|remembrance

confidential: confide|confided|confidential|secret|secrecy|secretly|secrets|"don't tell"|"keep it to yourself"

life event: marriage|marry|married|divorce|divorced|bereaved|bereavement|death|memorium|memoriam|obituary|obit|memorial|funeral|died|dying|fatal|"pass away"|born|birth

family: mom|dad|mother|father|husband|wife|hubby|brother|sister|cousin|uncle|aunt|grandfather|grandmother|grandpa|grandma|granny|son|daughter|stepson|stepdaughter|family|kin

religion: god|religion|church|almighty|bible|temple|christian|jewish|hindu|muslim|islamic|mosque|temple|cathedral|catholic|episcopal|prayer|pray|religious|reverent|reverend|moksha|dharma|karma|kismat|fatwa|fatwah|mitzvah|piety|protestant|clergy|clergyman|allah|gospel|monk|monastery|shia|sunni|sabbath|ramadan|psalm|pope|priest|passover|mormon|pagan|baptist|baptism|buddhist|buddha|chapel|chaplain|amish|amen|afterlife|pastor|pews|jesus

# curious: curious|curiosity|inquisitive|nosy|snoop|snooping

festivals: festival|Christmas|"New year"|thanksgiving|halloween|diwali|carnival|hannukah|oktoberfest|easter

love: beloved|valentine|romance|romantic|sweetheart|sweetie|sweetiepie|darling # removing "love" because M has too much of it...

vacations: holiday|vacation

disappointment: disappoint|disappointed|disappoints|disappointment|disappointing|discontent|bummer|bummed|disgust|disgusted|misery|miserable|bitter|bitterness|backfire

anxiety: anxious|anxiety

emotion: emotion|emotional|tears|teary|wrench

sorry: remorse|regret|regrets|apology|apologize|apologies

pity: pity

worry: worry|worried|worries|worrying|anxiety|anxious|panic|apprehensive|apprehension|anxious|anxiety

embarassment: embarass|embarassment|embarassed

medical: sick|ill|illness|sickness|medical|surgery|endoscopy|hospital|unwell|headache|depression|depressed|therapy|injure|hurt|injury|injured|injurious|doctor|surgeon|surgical|clinic|lethal|arthritis|suicide|laceration|trauma|traumatic|ptsd|schizophrenia|schizophrenic|disfigure|disfigured|disfiguring|radiation|medicine|wound|foetus|fetus|fetal|injure|disease|infection|vomit|puke|puking|seasick|carsick|nausea|nauseous|nauseating|nauseated|pallid|wan|miscarriage|"heart attack"|postpartum|hemorrhage|fracture|casualty|concussion|cancer|biopsy|malignant|leukemia|malignancy|pancreas|pancreatic|gastric|abdominal|menaloma|thyroid|cervical|cardiovascular|colorectal|ovarian|gastrointestinal|lung|lungs|thoracic|oesophagus|alzheimer|parkinson|pediatrician|orthopedic|cardiologist|urologist|oncologist|gynecologist|dermatologist|neurologist|anesthesiologist|anesthetist|geriatric|"spinal cord"|fever|diarrhoea|diarrhea

contempt: contempt|contemptuous

violence: violence|destroy|disturbed|disturbing|disturbance|disturbances|ravage|bomb|explode|explosion|devastate|devastation

hate: hate|loathe|despise

jealousy: jealous


despair: suicide|suicides|desperate|desperation|frustrate|frustrated|frustrating

fear: afraid|fear|nervous|petrified|petrify|petrifying|horror|horrified|nightmare|nightmarish

racy: sex|sexy|nsfw|erotic|erection|copulate|copulation|intercourse|horny|outercourse|aroused|boner|butt|condom|titillate|lechery|virginity|cunt|vagina|panties|chastity|lascivious|sexcapade|sexual|kinky|bondage|coitus|carnal|blowjob|"blow job"|cunnilingus|genital|nipple|tits|foreplay|lovemaking|extramarital|orgiastic|salacious|aphrodisiac|prurient|lustful|risque|"sex starved"|fornicate|sodomy|ejaculate|masturbate|adultery|incest|fondling|necking|petting|penis|semen|fetish|voyeur|slut|nude|nudity|nyphomaniac|porn|pubic|titties|whore|pornographic|raunchy|dick|testicle

emergency: emergency|accident|critical|flashpoint|catastrophe|crisis|panic

shock: shock|shocking|shocks|thunderstruck|stupefied|flabbergasted|dumbstruck|dumbfounded

expletives: goddamn|goddam|gaddamit|damn|fuck|f*ck|fucking|fucked|fucks|fucker|sonofabitch|wtf|mofo

sadness: cry|crying|sad|sadly|saddened|sadness|bleak|ouch|gloomy|crappy|crushed|distress|suffocate|lonely|rejected|pain|pained|morose|agony|anguish|dismay|dismayed|sympathy|"bad news"

conflict: fault|"mend fences"|contrite|contrition|struggle|complaint|refuse|refusal|disagree|disagreement|"don't trust"

anger: angry|anger|exasperate|angered|complain|complained|"freak out"|arrogant|bully|abuse|furious|infuriate|hackles|embitter|vitriol|vituperative|excoriate|rage|umbrage|outrage|madden|defame|slander|travesty|enrage|enraged|irate|wrath|livid|offense|indignant|indignation|tantrum|exasperate|exasperation|harass|harassment|torment|tormented|displeased|irritate|irritating|annoyed|annoying|hostile|hostility|hostilities|wreak|wreaking|"pissed off"|bitch|bitching|bitchy|rude|churlish

guilt: guilt|guilty|pang|criminal|rape|accuse|incriminating|culpable|prison|imprison|fraud|bogus|heinous|villainous

shame: shame|ashamed|shameful|shamefaced|humiliate|humiliated|humiliation|dishonour|dishonor|ignominy|opprobrium|odium|obloquy|sheepish|mortified|mortification

grief: grief|grieving|grieved|tragedy|aggrieved|anguish|suffer|suffering|sepulchral|mourn|mourning|condolence|bereave|sympathy|sympathies|heartbroken|"heart broken"|"last rites"|"sad news"|condolence|condolences|heartbreak|heartbroken|sorrow|heartbroken|heartbreak|"passed away"|died

#nice: honey

#posEmo: {wow}|{gratitude}|{pride}|{joy}|{nice}|{pos-surprise}|{humor} # no likes
#negEmo: {shame}|{disappointment}|{emotion}|{anxiety}|{sorry}|{pity}|{worry}|{embarassment}|{contempt}|{destructive}|{hate}|{jealousy}|{dislike}|{despair}|{fear}|{shock}|{sadness}|{conflict}|{guilt}

negative: lame|negative|terrible|dislike|yucky|unsavory|unsavoury|wrongful|vendetta|patronizing|crass|vulgar|sordid|devious|delusion|megalomania|neurotic|saddle|jackass|bozo|corrupt|worthless|plagiarize|henpecked|domineering|blasphemy|senile|reprehensible|"ill will"|unctuous|sloppy|obnoxious|noxious|noisome|supercilious|overbearing|torment|haughty|seedy|"wishy washy"|vain|vainglorious|quixotic|insidious|"hell pay"|vapid|stupid|idiot|moron|"swollen headed"|conceited|feckless|sadistic|"can worms"|sophistry
